....................
................X...
...........-....-...
....................
....................
....................
....................
....................
....................
....................
1...................
-..........-........
....................
CCCCCCCCCCCCCCCCCCCC
....................
